----------
-*+-------
----------
--++++----
--+-------
--+-------
--+-------
----------
----------
----------