*-*-*-*-*-*-*-*-*-*-*-
-*-*-*-*-*-*-*-*-*-*--
*-*-*-*-*-*-*-*-*-*-*-
-*-*-*-*-*-*-*-*-*-*--
*-*-*-*-*-*-*-*-*-*-*-
-*-*-*-*-*-*-*-*-*-*--
*-*-*-*-*-*-*-*-*-*-*-
-*-*-*-*-*-*-*-*-*-*--
*-*-*-*-*-*-*-*-*-*-*-
-*-*-*-*-*-*-*-*-*-*--
*-*-*-*-*-*-*-*-*-*-*-
-*-*-*-*-*-*-*-*-*-*--
*-*-*-*-*-*-*-*-*-*-*-
-*-*-*-*-*-*-*-*-*-*--
*-*-*-*-*-*-*-*-*-*-*-
-*-*-*-*-*-*-*-*-*-*-*
*-*-*-*-*-*-*-*-*-*-*+
-*-*-*-*-*-*-*-*-*-*-+
*-*-*-*-*-*-*-*-*-*-*+
-*-*-*-*-*-*-*-*-*-*-+
*-*-*-*-*-*-*-*-*-*-*+