-----+----
-------+--
----------
----------
---+------
----+-----
------+---
----------
----------
----------